    c#####     
  T ##   # c m 
    #    # t   
m ###    ######
  #.#.# ##.   #
### ###  ##   #
#   #  $  ## ##
#     $@$     #
#   #  $  #   #
######   ### ##
T#  .## #### # 
 #           # 
 ##  ######### 
  #### t    m  
